{
	"hitboxes" : [
		["x", "x", "x", "x", "x", "x", "x", "x", "x", "x"],
		["x", "x", "x", "f", "f", "f", "f", "x", "x", "x"],
		["x", "x", "f", "r", "r", "d", "f", "x", "x", "x"],
		["f", "f", "f", "u", "f", "d", "f", "x", "x", "x"],
		["s", "r", "r", "u", "f", "d", "f", "x", "x", "x"],
		["f", "f", "f", "f", "f", "d", "f", "x", "x", "x"],
		["x", "x", "x", "x", "f", "d", "f," "f", "f", "x"],
		["x", "x", "x", "x", "f", "r", "r", "r", "d", "x"],
		["x", "x", "x", "x", "f", "f", "f", "f", "d", "x"],
		["x", "x", "x", "x", "x", "x", "x", "x", "k", "x"]],
	"tileset": "test",
	"rounds": 5
}
